NO ./textures/eagle64.xpm
SO ./textures/mossy64.xpm
WE ./textures/window.xpm
EA ./textures/wood64.xpm

F 255,0,255
C 0,35,155

11111
10001
10N01
10001
11111