

NO ./textures/azulejo.xpm
SO ./textures/flowers.xpm
WE ./textures/window.xpm
EA ./textures/planches.xpm

F 181,86,144
C 255,154,86

111111111111111111111111111111
100000000000000000000000000001
100000000000000000000000000001
100000000000000000000000000001
100000000000000000000000000001
100000000000000000000000000001
100000000000000000000000000001
100000000000000110100000000001
100000000000001100100000000001
100000000000001100100000000001
1000S000000000100010
100000000000000000000000000001
100000001111111111111000000001
100000001000000000001000000001
100000001000000000000000000001
100000000000000000001000000001
100000001000000000001000000001
10000000100000000
100000001000000000001000000001
100000001000000000001000000001
100000001000000000001000000001
100000001000000000001000000001
100000001111111111111000000001
100000000000000000000000000001
100000000000000000000000000001
100000000000000000000000000001
100000000000000000000000000001
111111111111111111111111111111