NO ./textures/azulejo.xpm
SO ./textures/flowers.xpm
WE ./textures/window.xpm
EA ./textures/planches.xpm

F 0,0,255
C 0,35,155



111111
1N0001
111111