1111111111111111111111111111111
1P10000000000000000000000000001
1010001000010000CC00111110001C1
1010001000010000CC00000010001C1
1010001111111100CC00011110001C1
1000000000010000CC00100000001C1
1000000001111100CC00111110001C1
10000000000000000000000000001E1
1111111111111111111111111111111