111111111111111111111111111111
10000000000C00000C000000000001
101000100000101001000000010101
101000101010001001000000010101
1P000C00C0000000000000000000C1
111111111111111111111111011111
111111111111111111111111011111
10000000000C00000C000000000001
101001100000101111000000010101
101010101010001001000000010101
1000C00C00000001110000000000C1
10000000000C00000C000000000001
101001100000101001000000101001
101001101010001001000000010101
1E000000C0000000000000000000C1
111111111111111111111111111111